TILEMAP
30 14 							-- Size of tile map in tiles
64 64 							-- Tile size & block size
images/MegaTiled.png 	-- Tilesheet
8 8							-- Number of tiles in tilesheet
-3 -4 -5 -6 -7 -8 0 0 0 0 0 0 0 0 0 0 0 0 0 0 0 0 0 0 0 0 0 0 0 0
-3 0 0 0 0 0 0 0 0 0 0 0 0 0 0 0 0 0 0 0 0 0 0 0 0 0 0 0 0 0
0 0 0 0 0 0 0 0 0 0 0 0 0 0 0 0 0 0 0 0 0 0 0 0 0 0 0 0 0 0
0 0 0 0 0 0 0 0 0 0 0 0 38 0 0 0 0 0 0 0 0 0 0 0 0  0 0 0 0
0 0 0 0 0 0 0 0 0 0 38 38 0 0 0 0 0 0 0 0 0 0 0 0 0 0 0 0 0 0
0 0 0 0 0 -1 0 0 38 38 38 0 0 0 0 0 0 0 11 0 -3 9 0 0 0 0 0 0 0 0
0 0 0 20 18 17 17 17 17 17 17 17 17 17 17 17 17 17 17 17 17 17 19 0 0 0 0 0 0 0
0 0 0 4 37 37 37 37 37 37 37 37 37 37 37 37 28 28 28 28 28 28 3 0 0 0 0 0 0 0
0 0 0 46 53 53 53 53 53 53 53 53 53 53 40 48 48 48 48 47 53 53 45 0 0 0 0 0 0 0
0 0 0 0 0 0 -2 0 0 0 0 0 0 39 38 0 0 0 54 0 0 56 0 0 0 0 0 0 0 0
0 0 0 0 0 0 0 0 0 0 0 0 0 0 38 38 0 0 0 0 0 0 0 0 0 0 0 0 0 0
0 0 0 0 0 0 0 0 0 0 0 0 0 0 0 0 0 0 0 0 0 0 0 0 0 0 0 0 0 0
0 0 0 0 0 0 0 0 0 0 0 0 0 0 0 0 0 0 0 0 0 0 0 0 0 0 0 0 0 0
0 0 0 0 0 0 0 0 0 0 0 0 0 0 0 0 0 0 0 0 0 0 0 0 0 0 0 0 0 0
