TILEMAP
25 20 							-- Size of tile map in tiles
64 64 							-- Tile size & block size
images/MegaTiled.png 	-- Tilesheet
8 8							-- Number of tiles in tilesheet
0 0 0 0 0 0 0 0 0 0 0 0 0 0 0 0 0 0 0 0 0 0 0 0 0
0 0 0 0 0 0 0 0 0 0 0 0 0 0 0 0 0 0 0 0 0 0 0 0 0
0 0 0 0 0 0 0 0 0 0 0 0 0 0 0 0 0 0 0 0 0 0 0 0 0
0 0 0 0 0 0 0 0 0 0 0 0 0 0 0 0 0 0 0 0 0 0 0 0 0
0 0 0 0 0 0 0 0 0 0 0 0 0 0 0 0 0 0 0 0 0 0 0 0 0
0 0 0 0 0 0 0 0 0 0 0 0 0 0 0 0 0 0 0 0 0 0 0 0 0
0 0 0 0 0 0 -7 0 0 0 0 0 0 0 0 38 38 38 0 0 0 0 0 0 0
0 0 0 0 0 20 12 12 24 0 0 0 -1 0 0 38 38 38 0 0 0 0 0 0 0
0 0 0 0 0 4 28 28 28 18 17 17 17 25 12 12 12 12 12 12 19 0 0 0 0
0 0 0 0 0 4 28 28 28 28 28 28 28 28 28 28 28 28 28 28 3 0 0 0 0
0 0 0 0 0 4 28 28 28 28 28 28 28 28 28 28 28 28 28 28 3 0 0 0 0
0 0 0 0 0 46 53 53 53 40 48 48 48 47 28 28 28 28 28 28 3 0 0 0 0
0 0 0 0 0 0 0 0 0 0 -8 0 -2 0 15 53 53 53 53 53 45 0 0 0 0
0 0 0 0 0 0 0 0 0 0 0 0 0 0 0 0 0 0 0 26 0 0 0 0 0
0 0 0 0 0 0 0 0 0 0 0 0 0 0 0 0 0 0 0 0 0 0 0 0 0
0 0 0 0 0 0 0 0 0 0 0 0 0 0 0 0 0 0 0 0 0 0 0 0 0
0 0 0 0 0 0 0 0 0 0 0 0 0 0 0 0 0 0 0 0 0 0 0 0 0
0 0 0 0 0 0 0 0 0 0 0 0 0 0 0 0 0 0 0 0 0 0 0 0 0
0 0 0 0 0 0 0 0 0 0 0 0 0 0 0 0 0 0 0 0 0 0 0 0 0
0 0 0 0 0 0 0 0 0 0 0 0 0 0 0 0 0 0 0 0 0 0 0 0 0
