TILEMAP
25 20 							-- Size of tile map in tiles
64 64 							-- Tile size & block size
images/MegaTiled.png 	-- Tilesheet
8 8							-- Number of tiles in tilesheet
0 0 0 0 0 0 0 0 0 0 0 0 0 0 0 0 0 0 0 0 0 0 0 0 0
0 0 0 0 0 0 0 0 0 0 0 0 0 0 0 0 0 0 0 0 0 0 0 0 0
0 0 0 0 0 0 0 0 0 0 0 0 0 0 0 0 0 0 0 0 0 0 0 0 0
0 0 0 0 0 0 0 0 0 0 0 0 0 0 0 0 0 0 0 0 0 0 0 0 0
0 0 0 0 0 0 0 0 0 0 0 0 0 -5 0 0 0 0 0 0 0 -7 0 0 0
0 0 0 0 0 0 0 0 0 0 0 0 0 20 19 0 0 0 0 0 0 20 19 0 0
0 0 0 0 0 0 0 0 0 0 0 0 0 0 0 0 0 0 0 0 0 4 3 0 0
0 0 0 0 -1 0 0 0 0 0 0 0 0 0 -11 0 0 0 0 0 0 4 3 0 0
0 0 20 18 17 25 12 12 12 12 12 12 12 12 12 12 12 12 12 12 12 28 3 0 0
0 0 4 28 28 28 28 28 28 28 28 28 28 28 28 28 28 28 28 28 28 28 3 0 0
0 0 4 28 28 28 28 28 28 28 28 28 28 28 28 28 28 28 28 28 28 28 3 0 0
0 0 46 40 48 47 53 53 53 53 53 53 53 53 53 53 53 53 53 53 53 53 45 0 0
0 0 0 0 -2 0 0 0 0 0 0 0 0 0 0 0 0 0 0 0 -9 -8 -9 0 0
0 0 0 0 0 0 0 0 0 0 0 0 0 0 0 0 0 0 0 0 -9 -9 -9 0 0
0 0 0 0 0 0 0 0 0 0 0 0 0 0 0 0 0 0 0 0 0 0 0 0 0
0 0 0 0 0 0 0 0 0 0 0 0 0 0 0 0 0 0 0 0 0 0 0 0 0
0 0 0 0 0 0 0 0 0 0 0 0 0 0 0 0 0 0 0 0 0 0 0 0 0
0 0 0 0 0 0 0 0 0 0 0 0 0 0 0 0 0 0 0 0 0 0 0 0 0
0 0 0 0 0 0 0 0 0 0 0 0 0 0 0 0 0 0 0 0 0 0 0 0 0
0 0 0 0 0 0 0 0 0 0 0 0 0 0 0 0 0 0 0 0 0 0 0 0 0
