TILEMAP
25 20 							-- Size of tile map in tiles
64 64 							-- Tile size & block size
images/MegaTiled.png 	-- Tilesheet
8 8							-- Number of tiles in tilesheet
0 0 0 0 0 0 0 0 0 0 0 0 0 0 0 0 0 0 0 0 0 0 0 0 0
0 0 0 0 0 0 0 0 0 0 0 0 0 0 0 0 0 0 0 0 0 0 0 0 0
0 0 0 0 0 0 0 0 0 0 0 0 0 0 0 0 0 0 0 0 0 0 0 0 0
0 0 0 0 0 0 0 0 0 0 0 0 0 0 0 0 0 0 0 0 0 0 0 0 0
0 0 0 0 0 0 0 0 0 0 0 0 0 0 0 0 0 0 0 0 0 0 0 0 0
0 0 0 0 0 0 0 0 0 0 0 0 0 0 0 0 0 0 0 0 0 0 0 0 0
0 0 0 0 0 0 0 0 0 0 0 0 0 0 0 0 0 0 0 0 0 0 0 0 0
0 0 0 0 -1 0 0 0 0 0 0 0 0 0 0 0 -7 0 0 0 0 0 0 0 0
0 0 20 18 17 25 12 12 12 12 12 24 0 31 12 12 12 12 12 12 12 19 0 0 0
0 0 4 37 37 37 37 37 37 37 37 37 12 37 37 37 37 37 37 37 37 3 0 0 0
0 0 4 37 37 37 37 37 37 37 37 37 37 37 37 37 37 37 37 37 37 3 0 0 0
0 0 46 40 48 47 53 53 53 53 53 53 53 53 53 53 53 53 53 53 53 45 0 0 0
0 0 0 0 -2 0 38 0 38 0 0 0 0 0 0 0 0 0 0 -8 0 0 0 0 0
0 0 0 0 0 0 0 0 38 0 0 0 0 0 0 0 0 0 0 0 0 0 0 0 0
0 0 0 0 0 0 0 0 0 0 0 0 0 0 0 0 0 0 0 0 0 0 0 0 0
0 0 0 0 0 0 0 0 0 0 0 0 0 0 0 0 0 0 0 0 0 0 0 0 0
0 0 0 0 0 0 0 0 0 0 0 0 0 0 0 0 0 0 0 0 0 0 0 0 0
0 0 0 0 0 0 0 0 0 0 0 0 0 0 0 0 0 0 0 0 0 0 0 0 0
0 0 0 0 0 0 0 0 0 0 0 0 0 0 0 0 0 0 0 0 0 0 0 0 0
0 0 0 0 0 0 0 0 0 0 0 0 0 0 0 0 0 0 0 0 0 0 0 0 0
